SO ./textures/WALL83.xpm
NO ./textures/WALL102.xpm
S  ./textures/sprite3.xpm
EA ./textures/WALL32.xpm
WE ./textures/WALL99.xpm

R 1200 800

F    80, 90 , 100

C 117 , 187 , 253


1111111111111111111111111111111111111111111
100000000S000000000000000000000000000000001
1000000000000000000000000000000000111111111
1100000000000000000000000000000000000000001
1000000000000000002000000000000020000000001
1000002000000000000002000000000000000000001
1000000000000000000000000000000000000000111
10000000000000000000000000000000000000001
10000000000000000000000000000000000000001
10000000200000000200000000000000000000001
10000000000000000000000000000000000000001
1000000000000011111000000000000000200000111
100000000000001   10000000000000000001111
100000000000001   10000000000000000001
10000000000000111110000000000000000001
10000200000000000000000000000000000001
10000000000000000000000000200000000001
10000000000000000000000000000000000001
10000000000000000000000000000000000001
10000000000000000000000000000000000001
11111111111111111111111111111111111111
