SO ./textures/WALL95.xpm
NO ./textures/WALL102.xpm
S  ./textures/sprite3.xpm
EA ./textures/WALL83.xpm
WE ./textures/WALL69.xpm

R 3000 2000


F    80, 90 , 100

C 117 , 187 , 253


111111
100001
10S001
100001
100001
111111
